        #################
       #*****************#
      #***             ***#
      #**     $   $     **#
      #*  $              *#
      #*          ##  $  *# ##
      #*         #  #    *##  #
####  #*      $  #   #   *#   #
#  ## #*         #    ##@#    #
##  ###*   $     #            #
 ##  ##*       $#              #
  ##  #* $      #   .#     .#  #
   ####*        #   ##   # ##  #
     ##*     $  # ..         ..#
      #** $     # .. #  #  # ..#
      #***       #   #######  #
     ###**********#          #
    #   #####################
    #  ## #  #     #  # #  #
    ####  ###       ###  ##
Title: NYAN CAT
Collection: SOKOSTATION
Date: 2012-12-13
Author: Ghislain MARTIN
AuthorMail: sokoban@orange.fr
AuthorPage: www.sokoban.fr
