###################
#.....#.....#.....#
#.$$$ # $$$$#$$$$.#
#.$.$ .     .  .$.#
#.$ $ # $$$$#$$$$.#
#.$ $ #     #    .#
###.#####.#####.###
#.$ $ #.   .#    .#
#.$ $ # $$$ # $ $.#
#.$ $ . $@$ . $ $.#
#.$ $ # $$$ # $ $.#
#.    #.   .# $ $.#
###.#####.#####.###
#.    #     # $ $.#
#.$$$$#$$$$ # $ $.#
#.$.  .     . $.$.#
#.$$$$#$$$$ # $$$.#
#.....#.....#.....#
###################
Title: NEUF A LA COQUE
Collection: MONDE 25
Date: 2005-10-13
Author: Ghislain MARTIN
AuthorMail: sokoban@wanadoo.fr
AuthorPage: http://perso.wanadoo.fr/sokoban
