         #####
         #   ##
         #  * #
########### # ##
#           #  #
#           #$ #
#  ##$#######  #
#  # .*.... #$ #
#  # ....*. #  #
#  ####### ##$ #
#  # $ $ $$$ $ #
#  #          @#
################
Author: Ghislain MARTIN
Title: L'ENTREPOT QUI TUE
Collection: MONDE 04
AuthorMail: sokoban@wanadoo.fr
AuthorPage: http://perso.wanadoo.fr/sokoban
Date: 2001-04-01
