#########
#.  $  .#
# . $ . #
#  +$.  #
#$$$*$$$#
#  .$.  #
# . $ . #
#.  $  .#
#########
Author: Ghislain MARTIN
Title: LE TOURNIQUET
Collection: MONDE 04
AuthorMail: sokoban@wanadoo.fr
AuthorPage: http://perso.wanadoo.fr/sokoban
Date: 2001-04-01
