         #####
         #   #
         # # #
#####    # @ #    #####
#   ###### # ######   #
# $$#     ...     #$$ #
# $    # #.#.# #    $ #
# $ #     ...     # $ #
#   ###### # ######   #
#####    #   #    #####
         # # #
         #   #
         #####
Author: Ghislain MARTIN
Title: BOING 747
Collection: MONDE 06
AuthorMail: sokoban@wanadoo.fr
AuthorPage: http://perso.wanadoo.fr/sokoban
Date: 2001-05-01
