#########
#       #
# $.$.$ #
# .$.$. #
# $.@.$ #
# .$.$. #
# $.$.$ #
#       #
#########
Author: Ghislain MARTIN
Title: EN QUINCONCE
Collection: MONDE 08
AuthorMail: sokoban@wanadoo.fr
AuthorPage: http://perso.wanadoo.fr/sokoban
Date: 2002-02-19
