###########
#         #
# # # # # #
#  $.$.$. #
# # # # # #
#@ $.$.$. #
# # # # # #
#  $.$.$. #
# # # # # #
#         #
###########
Author: Ghislain MARTIN
Title: EN DECALAGE
Collection: MONDE 08
AuthorMail: sokoban@wanadoo.fr
AuthorPage: http://perso.wanadoo.fr/sokoban
Date: 2002-02-19
