#######
#*. .*#
#.$$$.#
# $@$ #
#.$$$.#
#*. .*#
#######
Author: Ghislain MARTIN
Title: TROP FASTOCHE
Collection: MONDE 10
AuthorMail: sokoban@wanadoo.fr
AuthorPage: http://perso.wanadoo.fr/sokoban
Date: 2003-01-27
