############
#          #
# .......$ #
# .$$$$$.$ #
# .$...$.$ #
# .$.$.$.$ #
# .$.$+$.$ #
# .$.$$$.$ #
# .$.....$ #
# .$$$$$$$ #
#          #
############
Author: Ghislain MARTIN
Title: LA SPIRALE
Collection: MONDE 11
AuthorMail: sokoban@wanadoo.fr
AuthorPage: http://perso.wanadoo.fr/sokoban
Date: 2003-02-19
