##########
#. .@. . #
#$.$.$.$.#
#.$.$.$.$#
#$.$.$.$.#
# $ $ $ $#
#        #
##########
Author: Ghislain MARTIN
Title: POUSSER EN ARRIERE
Collection: MONDE 11
AuthorMail: sokoban@wanadoo.fr
AuthorPage: http://perso.wanadoo.fr/sokoban
Date: 2003-03-10
