       ####
   #####  #
####      #
#.......  #
####  #   #
  ### #####
  #  $  #
  #  $  #
  ##$ $##
   # $ #
   #$ $#
   # @ #
   #####
Author: Ghislain MARTIN
Title: ANGLE MORT
Collection: MONDE 12
AuthorMail: sokoban@wanadoo.fr
AuthorPage: http://perso.wanadoo.fr/sokoban
Date: 2003-08-17
