         #
        # #
       #   #
      #     #
     # $   @ #
    # $ $     #
   # $   $     #
  # . $ $ $   #
 # . . $   $ #
# .   . $ $ #
 # . . . $ #
  # .   . #
   # . . #
    # . #
     # #
      #
Author: Ghislain MARTIN
Title: J'AI FAIT UN TETRIS
Collection: MONDE 12
AuthorMail: sokoban@wanadoo.fr
AuthorPage: http://perso.wanadoo.fr/sokoban
Date: 2003-08-17
