  ####
  #  #
###$.###
# .  $ #
# $  . #
### @###
# .  $ #
# $  . #
###.$###
  #  #
  ####
Author: Ghislain MARTIN
Title: NOUVEAUX TOURNICOTONS
Collection: MONDE 13
AuthorMail: sokoban@wanadoo.fr
AuthorPage: http://www.sokoban.fr.st
Date: 2003-11-19
