       #####
    ####   #
#####   $# #
#   # #.*  ###
#   $ $....  #
#######$#$## #
      #  @   #
      ########
Author: Ghislain MARTIN
Title: LE BULBE RACHIDIEN
Collection: MONDE 15
AuthorMail: sokoban@wanadoo.fr
AuthorPage: http://www.sokoban.fr.st
Date: 2003-11-27
