##################
#                #
# ########## ### #
#   #######    $ #
# $$#.....#  $$$ #
#  $ .....#$$$   #
# $$#..... $ $ $ #
# $ #.....#$ $$$ #
#   #######     @#
##################
Author: Ghislain MARTIN
Title: EN CONSTRUCTION
Collection: MONDE 16
AuthorMail: sokoban@wanadoo.fr
AuthorPage: http://www.sokoban.fr.st
Date: 2003-12-05
