 ####     ####
###.##   ##.###
#.$$.## ##.$$.#
##.$$.###.$$.##
 ##.$$...$$.##
  ##.$$$$$.##
   ##.$@$.##
  ##.$$$$$.##
 ##.$$...$$.##
##.$$.###.$$.##
#.$$.## ##.$$.#
###.##   ##.###
 ####     ####
Author: Ghislain MARTIN
Title: THE X FILES
Collection: MONDE 16
AuthorMail: sokoban@wanadoo.fr
AuthorPage: http://www.sokoban.fr.st
Date: 2003-12-05
