#########
#   @   #
# $$$$$ #
# $   $ #
# $   $ #
#### ####
# $ $ $ #
#.......#
# ..... #
#       #
### # ###
# ***** #
#       #
#       #
#####  ##
#########
Author: Ghislain MARTIN
Title: POUR SOUFFLER
Collection: MONDE 16
AuthorMail: sokoban@wanadoo.fr
AuthorPage: http://www.sokoban.fr.st
Date: 2003-12-05
