#######   #######
#.    #   #    .#
# $ $ #   #   $ #
#  $ $#   #$$$$ #
# $ $ #####   $ #
#  $ ...+...  $ #
#####.#####.#####
    #.#*#*#.#    
    #.#####.#    
    #.#*#*#.#    
#####.#####.#####
# $  ....... $  #
# $ $ #####  $  #
#  $  #   #$$$$ #
# $ $$#   #  $  #
#.    #   #    .#
#######   #######
Title: QUADRALOGIQUE
Collection: MONDE 19
Date: 2004/01/22
Author: Ghislain MARTIN
AuthorMail: sokoban@wanadoo.fr
AuthorPage: perso.wanadoo.fr/sokoban
