       #####    
      #  @ #    
     #  $$ #    
    #  $.$ #    
   #  $. $ #    
  #  $.# $ #    
 #  $.## $ #    
# $$.### $$#####
#.....*..*.....#
########$$ #####
       # $ #    
       #   #    
       #####    
Title: QUATRE FOUR CUATRO
Collection: MONDE 20
Date: 2004/01/31
Author: Ghislain MARTIN
AuthorMail: sokoban@wanadoo.fr
AuthorPage: perso.wanadoo.fr/sokoban
