###########
#         #
#  $ $ $  #
# $@$ $ $ #
#  $ ######
# $ $#     
#  $ #     
# $ $######
#  $     .#
# #$##### #
# #.....$ #
# #.###.# #
# #.#*#.# #
# #.###.# #
# $.....# #
# #####$# #
#.        #
###########
Title: SIX SIX SEIS
Collection: MONDE 20
Date: 2004/02/02
Author: Ghislain MARTIN
AuthorMail: sokoban@wanadoo.fr
AuthorPage: perso.wanadoo.fr/sokoban
