#####
# @ #
#   #
#.$.#
#$.$#
#   #
#.$.#
#$.$#
#   #
#.$.#
#$.$#
#   #
#.$.#
#$.$#
#   #
#.$.#
#$.$#
#   #
#   #
#####
Title: ENCORE ET ENCORE
Collection: MONDE 22
Date: 2005-06-30
Author: Ghislain MARTIN
AuthorMail: sokoban@wanadoo.fr
AuthorPage: http://perso.wanadoo.fr/sokoban/
