    #####          
    #   #          
    #$  #          
  ###  $##         
  #  $ $ #         
### # ## #   ######
#   # ## #####.  .#
# $  $       $....#
#####$### #@##.  .#
    #     #########
    #######        
Title: THINKING RABBIT STYLE
Collection: MONDE 25
Date: 2005-10-19
Author: Ghislain MARTIN
AuthorMail: sokoban@wanadoo.fr
AuthorPage: http://perso.wanadoo.fr/sokoban
