#############
#  .$ # $.  #
# $  .@.  $ #
#  .$ # $.  #
#############
Title: ET VICE VERSA
Collection: MONDE 26
Date: 2005-11-04
Author: Ghislain MARTIN
AuthorMail: sokoban@wanadoo.fr
AuthorPage: http://perso.wanadoo.fr/sokoban
