############
#          #
# *******+ #
# *        #
# * ****** #
# * *    * #
# * * $* * #
# * *  * * #
# * **** * #
# *      * #
# ******** #
#          #
############
Title: LOOP TWICE
Collection: MONDE 27
Date: 2006/07/08
Author: Ghislain MARTIN
AuthorMail: sokoban@orange.fr
AuthorPage: http://perso.orange.fr/sokoban/index.htm
