     #####
     #   #
  #### $ ####
  #  #   #  #
  # ## #### #
#####.*.*.#####
#   #*$ $*    #
# $ #. @ .# $ #
#    *$ $*#   #
#####.*.*.#####
  # #### ## #
  #  #   #  #
  #### $ ####
     #   #
     #####
Title: THE MAIN BRAIN
Collection: GHISMART2009
Date: 2009-07-18
Author: Ghislain Martin
AuthorMail: sokoban@orange.fr
AuthorPage: www.sokoban.fr
