#################
##  #  ###  #  ##
#  $ $  #  $ $  #
# $ # $ # $ # $ #
#   #   #   #   #
# $ # $ # $ # $ #
#   #   #   #   #
# $ #.......# $ #
#   #...+...#   #
#################
Title: MACDO
Collection: GHISMART2009
Date: 2009-07-19
Author: Ghislain Martin
AuthorMail: sokoban@orange.fr
AuthorPage: www.sokoban.fr
