   #####
   #   #
   # + #
#### * #
#    * #
# $*** #
#      #
########
Title: SMALL CORNER
Collection: GHISMART2009
Date: 2008-08-02
Author: Ghislain Martin
AuthorMail: sokoban@orange.fr
AuthorPage: www.sokoban.fr
