   ####
   #  #
   #  #
####$ ####
#   ..$  #
#  $..  @#
#### $####
   #  #
   #  #
   ####
Title: PHARMACIE
Collection: GHISMART2009
Date: 2009-08-07
Author: Ghislain Martin
AuthorMail: sokoban@orange.fr
AuthorPage: www.sokoban.fr
