#######
#  .  #
# .$. #
#**@**#
# $ $ #
#     #
#######
Title: VERS LE HAUT
Collection: GHISMART2009
Date: 2009-11-27
Author: Ghislain Martin
AuthorMail: sokoban@orange.fr
AuthorPage: www.sokoban.fr
