############
##       ###
## $ $ $   #
#  ######  #
# $#... #$ #
#  #... #  #
## #... #$ #
## ###.##  #
#    $$$ $ #
#   ##@ #  #
############
Title: EMBERLIFICOTAGE
Collection: SOKOSTATION
Date: 2012-05-18
Author: Ghislain Martin
AuthorMail: sokoban@orange.fr
AuthorPage: www.sokoban.fr
