############
#  . . . . #
# $$$$$$$$ #
# . . . .$.#
########.$ #
# . . . .$.#
#@$$$$$$$$ #
#  . . . . #
############
Title: VIRAGE INVERSE
Collection: SOKOSTATION
Date: 2012-05-21
Author: Ghislain Martin
AuthorMail: sokoban@orange.fr
AuthorPage: www.sokoban.fr
