#####################
#   #   #   #   #   #
# # # #   # # #   # #
#   #   #   #   #   #
###*###*###*###*###*#
#   #       #       #
#@#$# # # # # # # #.#
#       #       #   #
###*###*###*###*###*#
#   #   #   #   #   #
# #   # # #   # # # #
#   #   #   #   #   #
#####################
Title: IDEE PROVISOIRE
Collection: SOKOSTATION
Date: 2012-12-07
Author: Ghislain MARTIN
AuthorMail: sokoban@orange.fr
AuthorPage: www.sokoban.fr
