###########
#     ## @#
#  ## ##$ #
#   #$ $  #
#...# $ $ #
#... $ $  #
#...# $ $##
#***#    *#
###########
Title: KLASS HIC
Collection: SOKOSTATION
Date: 2012-12-16
Author: Ghislain MARTIN
AuthorMail: sokoban@orange.fr
AuthorPage: www.sokoban.fr
